%Created:3/5/17
%Updated:3/5/17
%
%DataStructureField|POSSIBLE DATA SET TERM1|POSSIBLE DATA SET TERM2|POSSIBLE DATA SET TERM3|...
AccumulatedDepreciation|ACCUMULATEDDEPRECIATION|ACCUMULATEDDEPRECIATIONDEPLETIONANDAMORTIZATIONPROPERTYPLANTANDEQUIPMENT
Assets|ASSETS
AssetsCurrent|ASSETSCURRENT
CashAndCashEquivalents|CASHANDCASHEQUIVALENTS|CASHANDCASHEQUIVALENTSATCARRYINGVALUE
ChangeInCashAndCashEquivalents|CHANGEINCASH|CHANGEINCASHANDCASHEQUIVALENTS|CASHANDCASHEQUIVALENTSPERIODINCREASEDECREASE
CommonStockDividendsPerShareDeclared|COMMONSTOCKDIVIDENDSPERSHARE|COMMONSTOCKDIVIDENDSPERSHAREDECLARED
CommonStockSharesAuthorized|COMMONSTOCKSHARESAUTHORIZED
CommonStockSharesIssued|COMMONSTOCKSHARESISSUED
CommonStockSharesOutstanding|COMMONSTOCKSHARESOUTSTANDING
CommonStockValue|COMMONSTOCKVALUE
ComprehensiveIncomeNetOfTaxe|COMPREHENSIVEINCOMENETOFTAX
CostOfGoodsSold|COSTOFGOODS|COSTOFGOODSSOLD
CostOfServices|COSTOFSERVICES
Depreciation|DEPRECIATION
DepreciationAndAmortization|DEPRECIATIONANDAMORTIZATION|DEPRECIATIONDEPLETIONANDAMORTIZATION|DEPRECIATIONAMORTIZATIONANDACCRETIONNET
DividendsCommonStock|DIVIDENDSCOMMONSTOCK|PAYMENTOFDIVIDENDSCOMMONSTOCK|PAYMENTSOFDIVIDENDSCOMMONSTOCK|DIVIDENDSANDDIVIDENDEQUIVALENTSDECLAREDONCOMMONSTOCKANDRESTRICTEDSTOCKUNITS
EarningsPerShareBasic|EARNINGSPERSHAREBASIC
EarningsPerShareDiluted|EARNINGSPERSHAREDILUTED
Goodwill|GOODWILL
GrossProfit|GROSSPROFIT
IncomeLossFromDiscontinuedOperationsNetOfTax|INCOMELOSSFROMDISCONTINUEDOPERATIONSNETOFTAX
IncomeTax|INCOMETAX|INCOMETAXEXPENSEBENEFIT
InterestAndDebtExpense|INTERESTANDDEBTEXPENSE
InterestPaidNetofInterestReceived|INTERESTPAIDNETOFINTERESTRECEIVED
Land|LAND
Liabilities|LIABILITIES
LiabilitiesAndStockholdersEquity|LIABILITIESANDSTOCKHOLDERSEQUITY
LiabilitiesCurrent|LIABILITIESCURRENT
LiabilitiesNonCurrent|LIABILITIESNONCURRENT
LongTermDebt|LONGTERMDEBT|LONGTERMDEBTANDCAPITALLEASEOBLIGATIONS|LONGTERMDEBTNONCURRENT
LongTermDebtCurrent|LONGTERMDEBTCURRENT
NetCashProvidedByUsedInFinancingActivities|NETCASHPROVIDEDBYUSEDINFINANCINGACTIVITIES|NETCASHPROVIDEDBYUSEDINFINANCINGACTIVITIESCONTINUINGOPERATIONS
NetCashProvidedByUsedInInvestingActivities|NETCASHPROVIDEDBYUSEDININVESTINGACTIVITIES|NETCASHPROVIDEDBYUSEDININVESTINGACTIVITIESCONTINUINGOPERATIONS
NetCashProvidedByUsedInOperatingActivities|NETCASHPROVIDEDBYUSEDINOPERATINGACTIVITIES|NETCASHPROVIDEDBYUSEDINOPERATINGACTIVITIESCONTINUINGOPERATIONS
NetCashProvidedByUsedInOperatingActivitiesContinuingOperations|NETCASHPROVIDEDBYUSEDINOPERATINGACTIVITIESCONTINUINGOPERATIONS
NetEarningsFromDiscontinuedOperations|NETEARNINGSFROMDISCONTINUEDOPERATIONS
NetIncomeLoss|NETINCOMELOSS
NumberOfDilutedSharesOutstanding|NUMBEROFDILUTEDSHARESOUTSTANDING|WEIGHTEDAVERAGENUMBEROFDILUTEDSHARESOUTSTANDING
NumberOfSharesOutstandingBasic|NUMBEROFSHARESOUTSTANDINGBASIC|WEIGHTEDAVERAGENUMBEROFSHARESOUTSTANDINGBASIC
OperatingExpenses|OPERATINGEXPENSES
OperatingIncomeLoss|OPERATINGINCOMELOSS
OtherAssetsCurrent|OTHERASSETSCURRENT
OtherLiabilitiesCurrent|OTHERLIABILITIESCURRENT
OtherLiabilitiesNoncurrent|OTHERLIABILITIESNONCURRENT
PaymentsForRepurchaseOfCommonStock|PAYMENTSFORREPURCHASEOFCOMMONSTOCK
PensionAndPostretirementPlansLiabilitiesNoncurrent|PENSIONANDOTHERPOSTRETIREMENTDEFINEDBENEFITPLANSLIABILITIESNONCURRENT
PensionContributions|PENSIONCONTRIBUTIONS
PreferredStockSharesOutstanding|PREFERREDSTOCKSHARESOUTSTANDING
PreferredStockValue|PREFERREDSTOCKVALUE
ProfitLoss|PROFITLOSS
Revenues|REVENUES
SalesRevenueGoodsNet|SALESREVENUEGOODSNET
SalesRevenueNet|SALESREVENUENET
SalesRevenueServicesNet|SALESREVENUESERVICESNET
StockholdersEquity|STOCKHOLDERSEQUITY
TreasuryStockShares|TREASURYSTOCKSHARES
%DONT LEAVE BLANK LINES